10,7,7,7,7,7,7,9,0,10,7,7,9,0,0,10,7,7,9,0,10,7,7,7,7,7,7,9
8,0,0,0,0,0,0,12,7,11,0,0,8,0,0,8,0,0,12,7,11,0,0,0,0,0,0,8
8,0,0,0,0,0,0,0,0,0,0,0,12,7,7,11,0,0,0,0,0,0,0,0,0,0,0,8
8,0,0,0,10,15,0,0,0,0,0,0,0,0,0,0,0,0,0,0,0,0,13,9,0,0,0,8
12,9,0,0,8,0,0,0,10,7,9,0,0,0,0,0,0,10,7,9,0,0,0,8,0,0,10,11
0,14,0,0,8,0,0,0,8,0,8,6,6,13,15,6,6,8,0,8,0,0,0,8,0,0,14,0
0,0,0,0,8,0,0,0,12,7,11,5,5,5,5,5,5,12,7,11,0,0,0,8,0,0,0,0
0,0,0,10,11,0,0,0,6,5,5,5,5,5,5,5,5,5,5,6,0,0,0,12,9,0,0,0
0,0,0,12,9,0,0,0,6,5,5,5,5,5,5,5,5,5,5,6,0,0,0,10,11,0,0,0
0,0,0,0,8,0,0,0,10,7,9,5,5,5,5,5,5,10,7,9,0,0,0,8,0,0,0,0
0,16,0,0,8,0,0,0,8,0,8,6,6,13,15,6,6,8,0,8,0,0,0,8,0,0,16,0
10,11,0,0,8,0,0,0,12,7,11,0,0,0,0,0,0,12,7,11,0,0,0,8,0,0,12,9
8,0,0,0,12,15,0,0,0,0,0,0,0,0,0,0,0,0,0,0,0,0,13,11,0,0,0,8
8,0,0,0,0,0,0,0,0,0,0,0,10,7,7,9,0,0,0,0,0,0,0,0,0,0,0,8
8,0,0,0,0,0,0,10,7,9,0,0,8,0,0,8,0,0,10,7,9,0,0,0,0,0,0,8
12,7,7,7,7,7,7,11,0,12,7,7,11,0,0,12,7,7,11,0,12,7,7,7,7,7,7,11