1,1,1,1,1,1,1,1,1,1,1,1,1,1,1,1,1,1,1,1,1,1,1,1,1,1,1,1
1,0,0,0,0,0,0,0,0,0,0,0,0,0,0,0,0,0,0,0,0,0,0,0,0,0,0,1
1,0,3,0,2,2,0,2,2,0,2,2,0,2,2,0,2,2,0,2,2,0,2,2,0,3,0,1
1,0,0,0,0,0,0,0,0,0,0,0,0,0,0,0,0,0,0,0,0,0,0,0,0,0,0,1
1,0,2,0,1,1,1,1,0,2,0,2,2,0,0,2,2,0,2,0,1,1,1,1,0,2,0,1
1,0,2,0,1,0,0,1,0,2,0,0,0,0,0,0,0,0,2,0,1,0,0,1,0,2,0,1
1,0,0,0,1,0,0,1,0,0,0,1,1,6,6,1,1,0,0,0,1,0,0,1,0,0,0,1
1,0,2,0,1,0,0,1,0,2,0,1,5,5,5,5,1,0,2,0,1,0,0,1,0,2,0,1
1,0,2,0,1,0,0,1,0,2,0,6,5,5,5,5,6,0,2,0,1,0,0,1,0,2,0,1
1,0,0,0,1,0,0,1,0,0,0,6,5,5,5,5,6,0,0,0,1,0,0,1,0,0,0,1
1,0,2,0,1,0,0,1,0,2,0,1,5,5,5,5,1,0,2,0,1,0,0,1,0,2,0,1
1,0,2,0,1,1,1,1,0,2,0,1,1,1,1,1,1,0,2,0,1,1,1,1,0,2,0,1
1,0,0,0,0,0,0,0,0,0,0,0,0,0,0,0,0,0,0,0,0,0,0,0,0,0,0,1
1,0,3,0,2,2,0,2,2,0,2,2,0,4,0,0,2,2,0,2,2,0,2,2,0,3,0,1
1,0,0,0,0,0,0,0,0,0,0,0,0,0,0,0,0,0,0,0,0,0,0,0,0,0,0,1
1,1,1,1,1,1,1,1,1,1,1,1,1,1,1,1,1,1,1,1,1,1,1,1,1,1,1,1