1,1,1,1,1,1,1,1,1,1,1,1,1,1,1,1,1,1,1,1,1,1,1,1,1,1,1,1
1,0,0,0,0,0,0,0,0,0,0,0,0,0,0,0,0,0,0,0,0,0,0,0,0,0,0,1
1,0,2,0,2,2,2,0,0,2,2,0,0,2,2,0,0,2,2,0,0,2,2,2,0,2,0,1
1,0,2,0,0,0,0,0,0,0,0,0,0,0,0,0,0,0,0,0,0,0,0,0,0,2,0,1
1,0,2,0,0,0,0,0,0,0,0,0,1,0,0,1,0,0,0,0,0,0,0,0,0,2,0,1
1,0,0,0,1,1,1,0,0,3,1,1,1,6,6,1,1,1,3,0,0,1,1,1,0,0,0,1
1,0,2,0,1,0,0,0,0,0,1,5,5,5,5,5,5,1,0,0,0,0,0,1,0,2,0,1
1,0,2,0,1,0,2,0,2,0,1,5,5,5,5,5,5,1,0,2,0,2,0,1,0,2,0,1
1,0,2,0,1,0,2,0,2,0,1,5,5,5,5,5,5,1,0,2,0,2,4,1,0,2,0,1
1,0,2,0,1,0,0,0,0,0,1,5,5,5,5,5,5,1,0,0,0,0,0,1,0,2,0,1
1,0,0,0,1,1,1,0,0,3,1,1,1,6,6,1,1,1,3,0,0,1,1,1,0,0,0,1
1,0,2,0,0,0,0,0,0,0,0,0,1,0,0,1,0,0,0,0,0,0,0,0,0,2,0,1
1,0,2,0,0,0,0,0,0,0,0,0,0,0,0,0,0,0,0,0,0,0,0,0,0,0,0,1
1,0,2,0,2,2,2,0,0,2,2,0,0,2,2,0,0,2,2,0,0,2,2,2,0,2,0,1
1,0,0,0,0,0,0,0,0,0,0,0,0,0,0,0,0,0,0,0,0,0,0,0,0,0,0,1
1,1,1,1,1,1,1,1,1,1,1,1,1,1,1,1,1,1,1,1,1,1,1,1,1,1,1,1