1,1,1,1,1,1,1,1,1,1,1,1,1,1,1,1,1,1,1,1,1
1,1,2,2,2,2,2,2,2,2,2,2,2,2,2,2,2,2,2,1,1
1,2,3,1,1,1,2,1,1,2,1,2,1,1,2,1,1,1,3,2,1
1,2,1,1,1,1,2,1,1,2,2,2,1,1,2,1,1,1,1,2,1
1,2,1,1,2,2,2,2,1,1,1,1,1,2,2,2,2,1,1,2,1
1,2,1,1,2,1,1,2,1,1,1,1,1,2,1,1,2,1,1,2,1
1,2,2,2,2,1,1,2,2,2,2,2,2,2,1,1,2,2,2,2,1
1,2,1,1,2,1,1,2,1,1,6,1,1,2,1,1,2,1,1,2,1
1,2,1,1,2,1,1,2,1,5,5,5,1,2,1,1,2,1,1,2,1
1,2,1,1,2,2,2,2,6,5,5,5,6,2,2,2,2,1,1,2,1
1,2,1,1,2,1,1,2,1,5,5,5,1,2,1,1,2,1,1,2,1
1,2,1,1,2,1,1,2,1,1,6,1,1,2,1,1,2,1,1,2,1
1,2,2,2,2,1,1,2,2,2,2,2,2,2,1,1,2,2,2,2,1
1,2,1,2,1,1,1,1,2,1,1,1,2,1,1,1,1,2,1,2,1
1,2,1,2,1,1,1,1,2,1,1,1,2,1,1,1,1,2,1,2,1
1,2,2,2,2,2,2,2,2,2,4,2,2,2,2,2,2,2,2,2,1
1,2,1,1,1,2,1,1,2,1,1,1,2,1,1,2,1,1,1,2,1
1,2,1,1,1,2,1,1,2,1,1,1,2,1,1,2,1,1,1,2,1
1,2,3,1,1,2,1,1,2,1,1,1,2,1,1,2,1,1,3,2,1
1,1,2,2,2,2,2,2,2,2,2,2,2,2,2,2,2,2,2,1,1
1,1,1,1,1,1,1,1,1,1,1,1,1,1,1,1,1,1,1,1,1